NO ./path_to_the_north_texture
SO ./path_to_the_south_texture
WE ./path_to_the_west_texture
EA ./path_to_the_east_texture

F 220,100,0
C 225,30,0

111111111111111111           111111111111111111111111
100000000000000001           100000000000000000000001
100000000000000001           100000000000000000000001
100000000000000001           100000000000000000000001
100000000000000001           100000000000000000000001
100000000000000001           100000000000000000000001
100000000011111111           100001111111111111111111
 1000000001                  100001
  100000001                  100001
   10000001                  1000011111111111111111
   10000001                  1000000000000000000001
   10000001                  100000000000000000001
   100000011111111111111111111000011111111111111111
   10000000000000000000000000000001
   10000000000000000000000000000001
   11111111111111111111111111111111