111111111111111111           111111111111111111111111
100000000000000001           100000000000000000000001
100000000000000001           100000000000000000000001
100000010000000001           100000000000000110000001
100000000000000001           100000000000000110000001
100000000000000001           100000000000000000000001
111100000011111111           100001111111111111111111
   10000001                  100001
   10000001                  100001
   10000001                  100001
   10000001                  100001
   10000001111111111111111111100001
   10000000000000000000000000000001
   10000000000000000000000000000001
   11111111111111111111111111111111
