F       138, 138, 138
C     56, 56, 56

NO         ./textures/greystone.XPM

SO        ./textures/redbrick.XPM
WE       ./textures/colorstone.XPM

EA        ./textures/eagle.XPM

111111111111
111101010011
100000000011
100101010011
100000000001
1101010100N1
111111111111
