EA textures/jroux-fo.xpm
NO                                                                  textures/wood.xpm
SO           textures/ychibani.xpm
WE textures/hspriet.xpm          

F  100,0,0
C 0 ,   0 , 167

11111111111111
10000000000001
100011111000011111
1000000000000000011111
1000000111100000011101
1000001 100111W0001 101
100000011110000001 101
100000000000011101  1
11111111111111 111




		1111111
		1110001
		1111111
