F 140,     160    , 200
C 0 ,   0 , 167
EA textures/jroux-fo.xpm
SO           textures/ychibani.xpm
WE textures/hspriet.xpm                                     
NO                                                                  textures/wood.xpm

11111111111111
10000000000001
10001111100001
10000000000001
100000W0000001
10000010000001
10000000000001
10000000000001
11111111111111
